где — В каком месте — <color=red>Где</color> мой ботинок?
ещё — До сих пор; дополнительно, вдобавок — Долго нам <color=red>ещё</color> идти до моря?
с — Отдаляясь от поверхности чего-то; в компании кого-то — Я сегодня пойду гулять <color=red>с</color> собакой
которое — Какое именно из нескольких; какая по порядку (о предмете женского рода или существе женского пола) — <color=red>Которое</color> пальто мне надеть?
про — О ком-то или о чём-то, на тему — На уроке географии нам рассказывали <color=red>про</color> Египет
у — Около, рядом с — Я оставил велосипед <color=red>у</color> ворот
ни — Даже; а также не, никакое из двух — Я не хочу <color=red>ни</color> суп, <color=red>ни</color> котлеты
под — Внизу, ниже поверхности — Портфель лежит <color=red>под</color> партой
над — Сверху, выше — Фотография висит <color=red>над</color> шкафом
этот — Находящийся здесь; предмет мужского рода, на который показывают — Давайте купим <color=red>этот</color> арбуз!
собой — Относительно себя (форма творительного падежа от "себя") — Я увидел за <color=red>собой</color> длинную тень
чему — Какому предмету, какому занятию; какому числу (форма дательного падежа от "что") — <color=red>Чему</color> равняется трижды два?
всё — Все вещи — <color=red>Всё</color> в комнате было зелёным
бы — При возможности; желательно чтобы — Появилась <color=red>бы</color> сейчас радуга!
в — Внутри; по направлению внутрь чего-то — <color=red>В</color> клетке был тигр
её — Принадлежащее ей, относящееся к ней (предмет или предметы); то, чем она владеет — Это <color=red>её</color> книги
перед — Напротив, у передней части; незадолго да чего-нибудь — Машина остановилась <color=red>перед</color> подъездом
или — Либо; в качестве варианта — Ты хочешь компот <color=red>или</color> сок?
будто — Словно; как — Облака проплывали <color=red>будто</color> корабли
другой — Не этот, иной (предмет, человек или животное мужского рода) — Мой фломастер плохо пишет. Ты не можешь дать мне <color=red>другой</color>?
он — Предмет мужского рода или существо мужского пола, о котором говорят — Я потерял свой портфель. Ты не знаешь, где <color=red>он</color>?
сделать — Выполнить; смастерить своими руками — Мой друг хочет <color=red>сделать</color> модель корабля
тот — Предмет или человек мужского рода, находящийся вдалеке или дальше — <color=red>Тот</color> жёлтый цветок я вырастила сама
свой — Собственный, личный (предмет мужского рода) — Слон поднял <color=red>свой</color> хобот
также — Кроме того, вдобавок — Моя сестра играет на скрипке, а <color=red>также</color> на гитаре
совсем — Совершенно, вполне — Этот магнитофон <color=red>совсем</color> новый
только — Лишь, исключительно — У меня осталось <color=red>только</color> два яблока
какие — Которые именно, что за (о предмете среднего рода) — <color=red>Какие</color> ботинки мне взять с собой в поход?
между — В пространстве, которое разделяет; в промежутке, посередине — Закладка лежит <color=red>между</color> страницами учебника
которая — Какая именно из нескольких; какая по порядку (о предмете женского рода или существе женского пола) — <color=red>Которая</color> из картин вам больше всего понравилась?
взять — Захватить рукой, получить; увезти или унести с собой — Ты можешь <color=red>взять</color> одно яблоко
на — Сверху и касаясь поверхности — Я приклеил марку <color=red>на</color> конверт
через — С одной стороны на другую, с одного конца до другого — Он перелез <color=red>через</color> забор
там — В том месте, вдалеке — <color=red>Там</color> моя черепашка
я — Тот, кто говорит или пишет о себе — <color=red>Я</color> ходил в спортзал
каждые — Все без исключения, всякие, любые — <color=red>Каждые</color> часы в доме показывали правильное время
о — Про, на тему — Моей сестре нравятся сказки <color=red>о</color> животных
эти — Находящиеся здесь; предметы, на которые показывают — <color=red>Эти</color> мячи будут нам нужны для игры
тобой — Сделано, сказанно человеком, с которым я говорю (форма творительного падежа от «ты») — Этот рисунок нарисован <color=red>тобой</color>?